...*...*.........
...*...*.#.#.....
.#.*...#.#.#.....
.#.*...#.#*#.....
.#.....#.#*#.....
.#....##.*.......
...#.....*.......
...#.....#l#*....
l..#..*..#l#*....
l..#..*...l......
ll...#..*.l#.....
ll...#..*.l#.....
.###lll*..l......
.###lll*.#l......
...*l#.#.#l#.....
...*l#.#...#.....
*#.*.#.#...#.....
*#.*.#.#.#.#....
.#...###.#.#.....
.#.#.###...#.....
.#.#.....#*#.....
.#.......#*#.....
.#...............
.#.#.###..s#.....
.#.#@#!#/.##.....