.................
...*l*...........
...*l*...........
....l.l..........
....l.l*.........
.l.....l.........
.l.....l#........
.ll.....l........
.ll.....l*.......
.l.......l.......
.l.......l#......
.l........l......
.l........l*.....
........llll.....
........llll#....
.......llllll....
.......llllll....
#......llllll....
#......l...ll....
##......l..ll....
##......l..ll....
*##......llll....
*##......llll....
**##.###.l..*....
**##@#!#/l..*....