.................
.................
.#.#.#.#.#.#.....
.#.#.#.#.#.#.....
.#.#.#.#.#.#.....
.#.#.#.#.#.#.....
.#.#.#*#.#.#.....
.#.#.#*#.#.#.....
.#.#.#.#.#.#.....
.#.#.....#.#.....
.#.#.....#.#.....
.....#.#.........
.....#.#.........
#.##.....##.#....
*.##.....##.*....
.....#.#.........
.....###.........
.#.#.###.#.#.....
.#.#.#.#.#.#.....
.#.#.#.#.#.#.....
.#.#.#.#.#.#.....
.#.#.....#.#.....
.#.#.....#.#.....
.#.#.###.#.#.....
....@#!#........