.................
.................
.#.#.#.#.#.#.....
.#.#.#.#.#.#.....
.#.#.#.#.#.#.....
.#.#@#.#.#.#.....
.#.#.#.#.#.#.....
.#.#.#.#.#.#.....
.#.#.#.#.#.#.....
.#.#.....#.#.....
.#.#.....#.#.....
.....#.#.........
.....#.#.........
#.##.....##.#....
..##.....##......
.....#.#.........
.....###.........
.#.#.###.#.#.....
.#.#.#.#.#.#.....
.#.#.#.#.#.#.....
.#.#.#.#.#.#.....
.#.#.....#.#.....
.#.#.....#.#.....
.#.#.....#.#.....