.................
....#...#........
.####...####.....
.####...####.....
.#....#....*.....
.#.##...##.*.....
.*.#l.*.l#.##....
.*.sl***ls.##....
.#..lllll..*#....
.#..lllll..*#....
.#..lllll..*#....
.s..lllll..s#....
#...l***l...#....
#*.#ls*sl#.##....
#*.##...##.#.....
#*....#....#.....
##....#....*.....
##.........*.....
#*.........#.....
##.........#.....
##.........*.....
####.....##**....
##s#.....#s#*....
##..s###s..#s....
##..@#!#/..s.....