.................
.####...####.....
.#.........*.....
.*.##......##....
.#.#.l.*.l.*#....
.....lllll..#....
#*...lllll..#....
#*.#.l.*.l.##....
##.##.....###....
#*.....#....#....
#*.....#....#....
#*lllll#llll#....
#*.....#....#....
#*.....#....#....
#*.....l....#....
###...lll.###....
#ll.......ll#....
#...........#....
#...##*##...#....
#.....*.....#....
#...........#....
#...........#....
#...........#....
.................
....@#!#/........