....##...........
....##...........
....#s..***......
....#.....*......
*.#.#............
*.#.s............
*.#...#..........
#.###.##.ww.w....
#.###.##.ww.w....
#.ss#....w.......
s...s....w.......
....ww.www.##....
....ww.www.##....
....w#.##........
....w#.##........
....w.....*......
....w.....*......
www.w.....##.....
www.w.....##.....
sss.s.....######.
....#............
###.######.......
##s......##......
#s...###..##.....
s...@#!#/........